333333333333333333333333333333
300000000000000000000000000003
300000000000000000000000000003
300011001100110011001100110003
300011001100110011001100110003
300011001100110011001100110003
300011001100110011001100110003
300011001100113311001100110003
300011001100113311001100110003
300011001100110011001100110003
300011001100000000001100110003
300011001100000000001100110003
300000000000110011000000000003
300000000000110011000000000003
311100111100000000001111001113
313300111100000000001111003313
300000000000110011000000000003
300000000000111111000000000003
300011001100111111001100110003
300011001100110011001100110003
300011001100110011001100110003
300011001100110011001100110003
300011001100000000001100110003
300011001100000000001100110003
300011001100011110001100110003
300000000000015510000000000003
300000000000015510000000000003
333333333333333333333333333333
